15 30
^###    #    #  #     ^       
#            #  #   #         
#          #    #            *
##       ###    #     6  *    
# #      #  #   #             
 #       #      #             
     D   #      #             
#         #     ##           #
# 6       #                   
#        #*#    #             
#        #*#    #   D   #    #
          #     #  #       # *
                #      %     #
*   #           # F          *
####     #     ###############
